51 24
ggggggggggggggggggggggggggggggggggggggggggggggggggg
g__________f______________________________________g
g___e_____________________________________________g
g________________________________________e________g
grrrrrrrrrrrrrrrrrrrrrrrrrrrrr____________________g
grrrrrrrrrrrrrrrrrrrrrrrrrrrrr____________________g
g_________________________________________________g
g_______________f___________________________f_____g
g_______________________rrg_______________________g
g_______________________rrg_______________________g
g____________f__________rrg___e___________________g
g_______________________rrg_______________________g
g____________f__________rrg_______________________g
g_______________________rrg___e___________________g
g_______________________rrg_______________________g
g_______________________rrg_______________________g
g_______rrrrrrrrrrrrrrrrrrg____________rrrrrrrrrrrg
g_______rrrrrrrrrrrrrrrrrrg____________rrrrrrrrrrrg
g_______rr________________________________________g
g_______rr________________________________________g
g__p____rr________________________e_________f_____g
g_______rr________________________________________g
g_______rr________________________________________g
ggggggggggggggggggggggggggggggggggggggggggggggggggg
