51 24
ggggggggggggggggggggggggggggggggggggggggggggggggggg
gs_________________rrr____________________g_______g
g__________________rrr____________________g_______g
g__________________rrr____________________g____f__g
g__________________rrr_____________e______g_______g
gggggggggggggggggggrrr____g_______________g_______g
g___r___rrr_______________g_______________g_______g
g___r___rrr_______________g_______________g_______g
g___g___rrr_______________g________________e______g
g___g___rrr_______________r__________________f____g
g___g___rrr_______________r_____________r_________g
g___g___rrr_______________r_____________r_________g
g___g___rrr________r____________________r____e____g
g___g___rrr________r___________ff_______g_________g
g___g___rrr________r___________ff_______g_________g
g___g___rrr________r____________________g____e____g
g_p_g___rrr________r____e_________rg______________g
g___r___rrr________r______________rg______________g
gggggggggggggggggggrrr_________f__rg__e______f____g
gs_________________rrr____________rg______________g
g__________________rrr____________rg______________g
g__________________rrr____________rg__________e___g
g__________________rrr____________rg______________g
ggggggggggggggggggggggggggggggggggggggggggggggggggg
