48 24
gggggggggggggggggggggggggggggggggggggggggggggggg
g______________________________________________g
g___e__________________________________________g
g________________________________________e_____g
grrrrrrrrrrrrrrrrrrrrrrrrrrrrr_________________g
grrrrrrrrrrrrrrrrrrrrrrrrrrrrr_________________g
g______________________________________________g
g______________________________________________g
g_______________________rrg____________________g
g_______________________rrg__e_________________g
g_______________________rrg____________________g
g_______________________rrg____________________g
g_______________________rrg____________________g
g_______________________rrg____________________g
g_______________________rrg____________________g
g_______________________rrg____________________g
g_______rrrrrrrrrrrrrrrrrrg____________rrrrrrrrg
g_______rrrrrrrrrrrrrrrrrrg____________rrrrrrrrg
g_______rr_____________________________________g
g_______rr_____________________________________g
g__p____rr________________________e____________g
g_______rr_____________________________________g
g_______rr_____________________________________g
gggggggggggggggggggggggggggggggggggggggggggggggg
