51 26
ggggggggggggggggggggggggggggggggggggggggggggggggggg
g_________________________________________________g
g___e_____________________________________________g
g________________________________________e________g
grrrrrrrrrrrrrrrrrrrrrrrrrrrrr____________________g
grrrrrrrrrrrrrrrrrrrrrrrrrrrrr____________________g
g_________________________________________________g
g_________________________________________________g
g_______________________rrg_______________________g
g_______________________rrg__e____________________g
g_______________________rrg_______________________g
g_______________________rrg_______________________g
g_______________________rrg_______________________g
g_______________________rrg_______________________g
g_______________________rrg_______________________g
g_______________________rrg_______________________g
g_______rrrrrrrrrrrrrrrrrrg____________rrrrrrrrrrrg
g_______rrrrrrrrrrrrrrrrrrg____________rrrrrrrrrrrg
g_______rr________________________________________g
g_______rr________________________________________g
g__p____rr________________________e_______________g
g_______rr________________________________________g
g_______rr________________________________________g
g_______rr________________________________________g
g_______rr________________________________________g
ggggggggggggggggggggggggggggggggggggggggggggggggggg
